7 3 3 3 3 3 3 3 3 3 3 3 3 3 3 3 3 3 3 3 3 3 3 3 3 3 3 3 3 3 3 3 3 3 3 3 3 3 3 8
5 0 1 0 1 0 1 1 0 1 0 1 1 0 1 0 1 1 0 0 0 1 0 1 0 0 1 0 1 1 0 1 0 1 0 1 0 0 1 6
5 0 1 1 0 1 1 1 1 0 1 0 0 1 1 0 1 0 0 1 0 1 2 1 0 0 0 1 1 0 1 0 0 0 1 1 1 0 1 6
5 1 1 1 0 0 0 1 1 1 0 0 1 0 0 0 0 0 0 1 1 0 1 0 0 0 0 0 1 1 1 0 0 0 0 0 1 0 0 6
5 0 11 11 11 1 1 1 0 1 1 0 0 0 1 0 1 0 1 1 1 0 0 0 15 0 1 1 0 0 1 1 0 0 1 0 0 0 1 6
5 0 1 14 11 0 0 1 1 1 0 0 1 0 1 1 0 0 1 0 1 0 15 15 15 1 1 1 1 1 0 1 1 1 1 0 1 0 1 6
5 0 1 1 1 0 1 1 1 1 1 0 0 1 0 0 1 1 1 1 1 1 0 15 15 15 0 0 0 0 1 1 0 0 0 0 0 0 0 6
5 0 1 1 0 0 1 0 1 0 1 1 0 1 0 1 1 0 0 1 1 0 1 0 1 1 0 1 1 1 1 0 1 0 1 1 1 0 0 6
5 1 0 1 0 1 1 1 1 0 0 0 0 0 0 0 1 1 1 0 1 0 1 1 1 0 1 0 0 1 0 1 1 1 1 1 1 1 0 6
5 1 0 0 0 1 1 1 0 0 1 1 1 0 0 0 2 0 1 1 1 0 0 1 0 1 0 1 0 2 0 1 1 0 0 1 0 0 1 6
5 0 1 0 0 0 0 0 1 1 1 1 0 0 0 1 1 0 0 1 0 1 1 0 0 0 1 1 1 0 0 0 0 1 0 1 1 0 0 6
5 1 1 1 1 0 0 1 1 0 0 0 1 0 0 1 1 0 1 1 0 0 0 1 1 0 1 0 0 1 0 0 0 1 1 0 1 1 0 6
5 0 0 0 0 0 1 0 1 0 0 1 1 1 0 0 1 1 1 1 1 1 0 0 0 0 1 0 0 0 0 1 0 0 1 1 0 1 0 6
5 1 0 0 1 1 0 0 0 0 1 1 1 0 1 0 1 0 0 0 0 1 1 1 1 1 1 1 0 1 0 0 1 1 1 1 1 1 1 6
5 1 0 0 0 1 1 0 0 0 0 0 1 1 0 1 0 1 0 0 1 0 1 0 1 1 1 1 0 1 0 0 0 1 1 1 0 1 0 6
5 1 1 1 0 0 1 1 0 1 1 1 0 0 1 0 1 1 0 1 1 1 0 0 1 0 0 1 1 1 0 0 1 0 0 1 0 1 0 6
5 1 1 0 0 1 1 1 1 0 0 1 1 0 0 1 13 0 1 0 1 0 0 0 0 1 1 0 1 0 0 0 0 1 1 0 0 1 0 6
5 0 0 0 1 0 0 0 0 0 0 0 0 0 1 1 13 13 1 1 1 0 1 1 0 1 1 1 0 1 1 1 1 0 0 1 0 1 0 6
5 1 1 0 0 1 1 1 2 1 0 0 1 0 1 13 13 13 1 0 1 0 1 0 1 0 1 1 0 1 0 0 1 0 0 1 0 1 0 6
5 0 0 1 0 1 1 1 1 1 1 1 0 1 1 1 13 0 0 1 0 0 1 0 0 0 1 0 1 1 0 0 1 0 0 1 0 1 1 6
5 1 1 1 1 0 1 1 0 1 1 1 0 1 1 1 0 0 0 1 2 0 0 1 0 1 1 0 1 0 1 0 0 1 0 0 1 0 0 6
5 0 1 0 0 0 0 0 1 1 0 0 1 0 0 1 1 0 1 0 1 0 0 0 1 0 1 1 1 0 0 1 1 2 0 0 0 0 1 6
5 0 0 1 0 1 0 1 1 0 1 1 1 0 1 0 0 1 0 1 0 0 1 0 1 1 0 1 0 1 1 0 1 0 0 1 1 0 1 6
5 0 1 0 0 1 1 0 1 1 0 0 0 1 1 0 1 1 1 1 1 0 0 0 1 0 1 1 1 1 1 0 1 0 1 0 0 1 1 6
10 4 4 4 4 4 4 4 4 4 4 4 4 4 4 4 4 4 4 4 4 4 4 4 4 4 4 4 4 4 4 4 4 4 4 4 4 4 4 9