7 3 3 3 3 3 3 3 3 3 3 3 3 3 3 8
5 0 1 0 0 0 1 0 1 0 0 1 0 1 0 6
5 0 1 1 0 1 1 1 1 1 0 1 1 1 0 6
5 1 0 1 0 0 0 2 0 1 1 0 0 0 1 6
5 1 0 1 1 1 0 0 1 1 1 1 1 1 1 6
5 1 1 1 0 1 1 1 0 1 0 1 1 1 0 6
5 1 1 0 1 1 0 1 1 1 1 0 1 1 1 6
5 0 0 0 1 1 1 1 1 1 0 2 0 1 0 6
5 1 1 0 1 0 1 0 1 1 0 0 0 1 1 6
5 1 1 2 0 0 0 1 0 0 0 1 0 1 1 6
5 1 1 1 1 1 0 0 1 0 0 1 0 0 1 6
10 4 4 4 4 4 4 4 4 4 4 4 4 4 4 9
