7 3 3 3 3 3 3 3 3 3 3 3 3 3 3 3 3 3 3 3 3 3 3 3 3 3 3 3 3 3 3 3 3 3 3 3 3 3 3 8
5 0 1 0 1 0 1 1 0 1 0 1 1 0 1 0 1 1 0 0 0 1 0 1 0 0 1 0 1 1 0 1 0 1 0 1 0 0 1 6
5 0 1 1 0 1 1 1 1 0 1 0 0 1 1 0 1 0 0 1 0 1 2 1 0 0 0 1 1 0 1 0 0 0 1 1 1 0 1 6
5 1 1 1 0 0 0 1 1 1 0 0 1 0 0 0 0 0 0 1 1 0 1 0 0 0 0 0 1 1 1 0 0 0 0 0 1 0 0 6
5 0 11 11 11 1 1 1 0 1 1 0 0 0 1 0 1 0 1 1 1 0 0 0 15 0 1 1 0 0 1 1 0 0 1 0 0 0 1 6
5 0 1 14 11 0 0 1 1 1 0 0 1 0 1 1 0 0 1 0 1 0 15 15 15 1 1 1 1 1 0 1 1 1 1 0 1 0 1 6
5 0 1 1 1 0 1 1 1 1 1 0 0 1 0 0 1 1 1 1 1 1 0 15 15 15 0 0 0 0 1 1 0 0 0 0 0 0 0 6
5 0 1 1 0 0 1 0 1 0 1 1 0 1 0 1 1 0 0 1 1 0 1 0 1 1 0 1 1 1 1 0 1 0 1 1 1 0 0 6
5 1 0 0 0 1 1 1 0 0 1 1 1 0 0 0 2 0 1 1 1 0 0 1 0 1 0 1 0 2 0 1 1 0 0 1 0 0 1 6
5 0 1 0 0 17 18 19 1 0 0 1 1 0 0 0 1 1 0 0 1 0 1 1 0 0 0 0 1 1 0 0 1 0 1 0 1 1 0 6
5 1 1 1 1 24 25 27 18 19 0 0 1 0 0 1 1 0 1 1 0 0 0 1 1 0 0 1 1 0 1 1 0 0 1 1 0 1 0 6
5 0 0 0 0 23 22 22 22 21 0 1 1 1 0 0 1 1 1 1 1 1 0 0 0 1 0 0 1 1 1 1 1 0 0 1 1 0 0 6
5 1 0 0 1 1 0 0 0 0 1 1 1 0 1 0 1 0 0 0 0 1 1 1 1 1 1 1 0 1 0 0 1 17 18 18 18 18 18 6
5 1 0 0 0 1 1 0 0 0 0 0 1 1 0 1 0 1 0 0 1 0 1 0 1 1 1 1 0 1 0 0 0 24 25 16 16 25 16 6
5 1 1 1 0 0 1 1 0 1 1 1 0 0 1 0 1 1 0 1 1 1 0 0 1 0 0 1 1 1 0 0 1 24 16 25 28 22 22 6
5 1 1 0 0 1 1 1 1 0 0 1 1 0 0 1 13 0 1 0 1 0 0 0 0 1 0 1 0 0 0 0 1 23 22 22 21 1 1 6
5 0 0 0 1 0 0 0 0 0 0 0 0 0 1 1 13 13 1 1 1 0 1 1 1 1 0 1 1 1 1 0 1 1 1 1 0 0 1 0 1 6
5 0 0 0 1 0 0 0 0 0 0 0 0 0 1 1 13 13 1 1 1 0 1 1 1 1 0 1 1 1 1 0 1 1 1 1 0 0 1 0 1 6
5 0 0 0 1 0 0 0 0 0 0 0 0 0 13 13 13 13 1 1 1 0 1 1 1 1 0 1 1 1 1 0 1 1 1 1 0 0 1 0 1 6
5 1 1 0 0 1 1 1 2 1 0 0 1 0 1 13 13 13 1 1 0 1 0 1 0 1 1 1 1 0 1 0 0 17 18 18 19 1 1 6
5 0 0 1 0 1 1 1 1 1 1 1 0 1 1 1 13 0 0 1 0 0 1 0 0 0 1 0 1 1 1 1 0 24 25 16 27 18 18 6
5 1 1 1 1 0 1 1 0 1 1 1 0 1 1 1 0 0 0 1 2 0 0 1 0 1 1 0 1 0 1 1 0 24 16 16 16 16 25 6
5 0 1 0 0 0 0 0 1 1 0 0 1 0 0 1 1 0 1 0 1 0 0 0 1 0 1 1 1 1 0 0 1 23 22 22 22 22 22 6
5 0 1 0 0 1 1 0 1 1 0 0 0 1 1 0 1 1 1 1 1 0 0 0 1 0 1 1 1 1 1 0 1 0 1 0 0 1 1 6
10 4 4 4 4 4 4 4 4 4 4 4 4 4 4 4 4 4 4 4 4 4 4 4 4 4 4 4 4 4 4 4 4 4 4 4 4 4 4 9